0  0  0  0  0  0  0  0  0  0  0  0
0  0  0  0  0  0  0  0  0  0  0  0
0  0  0  0  0  0  0  0  0  0  0  0
0  0  0 10 10  8  8 10 10  0  0  0
0  0  0 10 10  8  8 10 10  0  0  0
0  0  0  8  8  6  6  8  8  0  0  0
0  0  0  8  8  6  6  8  8  0  0  0
0  0  0 10 10  8  8 10 10  0  0  0
0  0  0 10 10  8  8 10 10  0  0  0
0  0  0  0  0  0  0  0  0  0  0  0
0  0  0  0  0  0  0  0  0  0  0  0
0  0  0  0  0  0  0  0  0  0  0  0
